add	thêm/cộng
change	thay đổi
criterion	tiêu chuẩn
eight	8
eleven	11
five	5
four	4
hello	xin chào
nine	9
pale	nhợt nhạt
plug	cắm vào
seven	7
six	6
ten	10
trace	lần dấu vết
tractor	máy kéo
transaction	giao dịch
translate	dịch
transparent	trong suốt
twelve	12
two	2
